**********
*        *
*  *  *  *
***** ****
*        *
*  *******
*        *
******** *
*        *
**********
