**********
*  * *   *
* **   * *
*   ** * *
***  * * *
**  *  * *
*  **  * *
**  *  * *
* *    * *
**********
