**********
*        *
*   * *  *
**   **  *
**       *
*   * *  *
* * *    *
*   * *  *
*   * *  *
**********
