**********
*  ***   *
*  *   * *
*    * ***
* *** *  *
*   *    *
* *   *  *
*  ** *  *
*    *   *
**********