**********
*        *
* ********
* *  **  *
* *      *
* *** *  *
* * *    *
*  ** *  *
*  ** *  *
**********
