**********
*  *   * *
*  *   * *
*    **  *
* ***    *
*   *    *
* *   *  *
* *** ** *
**       *
**********